NO map/textures/matrix.xpm

SO map/textures/matrix.xpm

WE map/textures/matrix.xpm

EA         map/textures/matrix.xpm

C 1,224,222

F       122,     122,      123

11111111
1000000N1
11111111