
NO map/textures/matrix.xpm

SO map/textures/matrix.xpm

WE map/textures/matrix.xpm

EA       map/textures/matrix.xpm  

F       1,78,0
C    12,0,255



11111111111111111111111
11
1
1
111111111111111111111111111111111111111
1
1
1
1
1
111111111111111111
110000N00001111111
011111111111111111

