WE ../../map/textures/we_t.xpm
NO ../../map/textures/no_t.xpm
SO ../../map/textures/so_t.xpm
EA ../../map/textures/ea_t.xpm
C 1,224,222
F       122,     122,      123

1111111111111111111111111111111111111111111
111111111011000001110000000000001
10000000001100000111011111111                          111111111
11110111111111011100000010001                          100000001
1111011111111101110101000N001                          100000001
110000001101010     111000001                         11111111111
10000000000000000000000010001     
10000000000000001101010010001
1100000111010101111101111000111
11110111 1110101 101111010001
11111111 1111111 111111111111