
NO map/textures/matrix.xpm

SO map/textures/matrix.xpm

WE map/textures/matrix.xpm

EA       map/textures/matrix.xpm       












F       1,78,0
C    12,0,255


11111111111
1101011N1110
11111011111