WE map/textures/we_t.xpm
NO map/textures/no_t.xpm
SO map/textures/so_t.xpm
EA map/textures/ea_t.xpm

C 1,224,222
F       122,     122,      123

1111111111111111111111111111111111111111111
111111111011000001110000000000001
10000000001100000111011111111      11111
11110111111111011100000010001
11110111111111011101010000001
11000000110101011100000010001
10000000000000000000000010001
10000000000000001101010010001
11000001110101011111011110N0111
11110111 1110101 101111010001
11111111 1111111 111111111111