
NO map/textures/matrix.xpm

SO map/textures/matrix.xpm

WE map/textures/matrix.xpm

EA       map/textures/matrix.xpm       


F       1,78,0
C    12,0,255





       




11111


11111111111
10100000101
10101010101
100N1010001
11111010111