NO map/textures/matrix.xpm

SO map/textures/matrix.xpm

WE map/textures/matrix.xpm



EA       map/textures/matrix.xpm

C 255,200,205      
F 122,122,123


11111111111111111
100000N000000111
1111111111111111111111111111111111