NO       textures/matrix.xpm          
C 0,0,0
WE textures/matrix.xpm
EA textures/matrix.xpm

F 0,0,0
SO textures/matrix.xpm

11111111111111111111111111111111
101000001000000000001111111
101010101011111110001
100010100010000010001
111110101111101011101             111111111
1000001010001010000001            100000001
101111101011101111111             111111111
101000001010100000101
101011111010111110101
101010001010100010101
101110101010101010101
100000101010001010001
111111101011111011101
100000101000100010001
101110101110101110111
101000100000100010101
101011111111111010101
100010000000000010001
101010111011111111101
1N1000001000000000001
111111111111111111111

